################ ################################### ################
#                                                                   #
# ############## # #### ##################### #### # ############## #
# #%%%%%%%%%%%%# # #%%# #%%%%%%%%%%%%%%%%%%%# #%%# # #%%%%%%%%%%%%# #
# ############## # #%%# ##################### #%%# # ############## #
#                # #%%#                       #%%# #                #
######## ######### #%%# ##################### #%%# ######### ########
#                # #%%#           @           #%%# #                #
# ############## # #%%# ##################### #%%# # ############## #
# #            # # #%%# #%%%%%%%%%%%%%%%%%%%# #%%# # #            # #
    ##########   # #%%# #%%%%%%%%%%%%%%%%%%%# #%%# #   ##########    
# #            # # #%%# #%%%%%%%%%%%%%%%%%%%# #%%# # #            # #
# ############## # #%%# ##################### #%%# # ############## #
#                # #%%#                       #%%# #                #
# ############## # #%%# ###   ###   ###   ### #%%# # ############## #
# #%%%%%%%%%%%%# # #%%# #    $    $    $    # #%%# # #%%%%%%%%%%%%# #
# ############## # #### ##################### #### # ############## #
#                                                                   #
################ ################################### ################
%%%%%%%%%%%%%%%%%%%%%%%%%%%%%&%%%%%%%%%%%%%%%%%%%%%%%%%%%%%%%%%%%%%%%
