%%%%%%%%%%%%%%%%%%%%%%%%%%%%%%%%%%%%%%%%%%%%%%%%%%%%%%%%%%&                          
%%%%%%%%%%%%%%%%%%%%%%%%%%%%%%%%%%%%%%%%%%%%%%%%%%%%%%%%%%%%%%%%%%%%%%%%%%%%%%%
%%%%%%%%%%%%%%%%%%%%%%%%%%%%%%%%%%%%%%%%%%%%%%%%%%%%%%%%%%%%%%%%%%%%%%%%%%%%%%%
###### ### ####################################################################
#             #             #                    #                  %%%%%     #
#             #             #                    #                  %%@%%     #
#                                                                   %%%%%     #
#              #             #                    #                           #
#              #             # ###  ###  ###  ### ####  #######################
#              #             #                    #                           #
#              #             #   $   $   $   $    #                           #
#              #             #                    #                           #
##### ### #####################################################################