#################################### #################################
#                                                   #                #
# ############## # #### ###################### #### # ############## #
# ############## # #### ###################### #### # ############## #
# ############## # #### ###################### #### # ############## #
#                # ####                        ####                # #
# #### ###### #### #### ### # ########## # ### #### ########### #### #
# #### ###### #### #### ### #            # ### #### ########### #### #
# #### ###### #### #### ### # ########## # ### #### ########### #### #
                        ### #  $   $   # # ###      ##          ####  
# #### ###### #### #### ### # ######## # # ### #### ########### #### #
# #### ###### #### #### ### #  $   $   # # ### #### ########### #### #
# #### ###### #### #### ### # ########## # ### #### ########### #### #
#                     #            #     #     ####                # #
# ############## # #### ###################### #### # ############## #
# ############## # #### ###################### #### # ############## #
# ############## # #### ###################### #### # ############## #
#@                                                  #                #
#################################### #################################

&