%%%%%%%%%%%%%%%%%%%%%
%%%%%%%%%%%%%%%%%%%%%
%%%######## #########
%%%#               $#
%%%# ############## #
%%%# #%%%%%%%%%%%%# #
%%%# ############## #
%%%#                #
%%%# #####   ###### #%%%%%%%%&%%%%%%%%%%
%%%# #            # #
%%%    ### @ ####    
%%%# #            # #
%%%# #####   ###### #
%%%#                #
%%%# ############## #
%%%# #%%%%%%%%%%%%# #
%%%# ############## #
%%%#$               #
%%%######## #########
%%%%%%%%%%%%%%%%%%%%%